[level]
tileset = level01.png
map = .............
      .=.=.=.=.=.=.
      .=.=.=.=.=.=.
      .=.=.=+=.=.=.
      .=.=.=.=.=.=.
      .=.=.....=.=.
      .....=.=.....
      +.==.....==.+
      .....=.=.....
      .=.=.===.=.=.
      .=.=.=.=.=.=.
      .=.=.=.=.=.=.
      .=.=.....=.=.
      .=.=.===.=.=.
      .....=.=.....
width = 13
height = 15

[.]
name = floor

[=]
name = brick
wall = true
block = true
destroyable = true

[+]
name = steel
wall = true
block = true
destroyable = false
